S.POMBE AAAAAAAAAA
SQU.ACANTH AAAAAAAACY
H.SAPIEN.2 AAAAAAAACZ
S.ALBA.2 AAAAAAAAAB
G.SERRULAT AAAAAAAADA
S.PASTORIA AAAAAAAAAC
P.FIMBRIAT AAAAAAAADB
FRA.X.ANAN AAAAAAAADC
T.THERMOPH AAAAAAAAAD
E.HISTOL.1 AAAAAAAADD
S.MOULEI AAAAAAAADE
S.GIGANTEA AAAAAAAAAE
P.PINNATIF AAAAAAAAAF
A.ALBOPICT AAAAAAAAAG
C.ALBICA.2 AAAAAAAAAH
SAC.FIBULI AAAAAAAADF
EPT.STOUTI AAAAAAAAAI
HAM.VIRGIN AAAAAAAAAJ
T.SIMIAE AAAAAAAAAK
P.LUCIDA AAAAAAAADH
P.MELANOID AAAAAAAADG
LIT.TRIFOL AAAAAAAAAL
BLA.EMERSO AAAAAAAAAM
F.NEOFOR.B AAAAAAAAAN
G.CAULACAN AAAAAAAAAO
T.CONGOL.3 AAAAAAAAAP
E.DISTACHY AAAAAAAADI
C.LIMON AAAAAAAAAQ
T.GOND.RH AAAAAAAADJ
E.COLI.REF AAAAAAAADK
G.ACEROSA AAAAAAAAAR
TEL.GRANDI AAAAAAAADL
S.CEREVI.3 AAAAAAAADM
FUN.HYGROM AAAAAAAAAS
T.PARVA.1 AAAAAAAAAT
B.NAPUS AAAAAAAAAU
PLU.AURICU AAAAAAAAAV
NOS.APIS.1 AAAAAAAADN
S.CAPRACAN AAAAAAAAAW
ENT.AULICA AAAAAAAADP
T.GOND.RH2 AAAAAAAADO
ANG.ROSTRA AAAAAAAAAX
A.THALIA.1 AAAAAAAAAY
E.TENELLA AAAAAAAADQ
PRO.AETHIO AAAAAAAAAZ
G.LATIFOLI AAAAAAAABA
G.AMERICAN AAAAAAAABB
CHI.TENTAN AAAAAAAABC
I.FELIS AAAAAAAABD
T.CONGOL.1 AAAAAAAADR
T.CRUZI.1 AAAAAAAADS
S.JAPONICU AAAAAAAADT
S.MURIS AAAAAAAADU
MICR.57864 AAAAAAAABE
T.CRUZI.2 AAAAAAAADV
D.MELANO.1 AAAAAAAABF
N.CANINUM AAAAAAAABG
TRI.AEQUAL AAAAAAAABH
R.RACEMO.2 AAAAAAAADW
TRE.AGILIS AAAAAAAABI
D.IRIDIS AAAAAAAABJ
T.DUBIUS AAAAAAAADX
S.ALBA.1 AAAAAAAABK
G.FLORIDAN AAAAAAAADY
C.FASCIC.1 AAAAAAAABL
T.BRUCEI AAAAAAAABM
P.MICANS AAAAAAAABN
P.POLYCE.1 AAAAAAAADZ
H.CATENOID AAAAAAAAEA
ACI.BREVIR AAAAAAAABO
P.VIRIDICA AAAAAAAAEB
PET.MARINU AAAAAAAAEC
PEL.TELLIM AAAAAAAABP
T.PYRIFO.1 AAAAAAAABQ
S.PSEUDOCO AAAAAAAAED
H.SAPIEN.3 AAAAAAAAEE
P.MEGASPER AAAAAAAABR
R.NORVEGIC AAAAAAAABS
T.VIVAX AAAAAAAAEF
X.LAEVIS.2 AAAAAAAAEG
E.GRACILIS AAAAAAAABT
JEP.PARRYI AAAAAAAAEH
BRA.FLORID AAAAAAAAEI
G.MURIS AAAAAAAAEJ
L.ESCULENT AAAAAAAAEK
S.CEREVI.2 AAAAAAAAEL
SAX.MERTEN AAAAAAAABU
A.THALIA.2 AAAAAAAABV
TRI.MATSUT AAAAAAAAEM
P.AURANTIO AAAAAAAABW
P.SUBCOSTA AAAAAAAAEN
ANO.ALBIMA AAAAAAAABX
C.ALBICA.1 AAAAAAAAEO
H.SAPIEN.1 AAAAAAAABY
C.ELLIPSOI AAAAAAAAEP
D.WINTERI AAAAAAAAEQ
NOS.APIS.2 AAAAAAAABZ
G.ARDEAE AAAAAAAAER
CH.CCMP621 AAAAAAAACA
P.CARINII AAAAAAAACB
E.LUCIDA AAAAAAAACC
S.CEREVI.1 AAAAAAAACD
M.MUSCULUS AAAAAAAAES
C.IMPLEXA AAAAAAAACE
T.CONGOL.4 AAAAAAAAET
P.FALCIP.A AAAAAAAACF
T.PARVA.2 AAAAAAAACG
T.GOND.P AAAAAAAACH
GELIDIU.SP AAAAAAAAEU
NEO.FORSTE AAAAAAAAEV
R.RACEMO.1 AAAAAAAAEW
D.DISCOIDE AAAAAAAAEX
H.MOMUS AAAAAAAAEY
P.FALCIP.S AAAAAAAACI
T.TAUROTRA AAAAAAAAEZ
LEP.PARADO AAAAAAAACJ
D.TIGRINA AAAAAAAAFA
X.BOREALIS AAAAAAAAFB
P.EXPANSUM AAAAAAAACK
CYP.CARPIO AAAAAAAACL
ONC.MYKI.1 AAAAAAAAFE
P.CYCLOPIU AAAAAAAAFD
O.PRISTOID AAAAAAAAFC
E.CUNICULI AAAAAAAACM
M.PENTANDR AAAAAAAAFG
NAN.SALINA AAAAAAAAFF
P.CAPILLAC AAAAAAAACN
HYD.COLLIE AAAAAAAACO
C.ELEGANS AAAAAAAACP
G.INTEST.1 AAAAAAAAFH
G.SESQUIPE AAAAAAAACQ
O.SATIVA AAAAAAAACR
X.LAEVIS.1 AAAAAAAACS
P.VERRUCOS AAAAAAAAFI
T.GOND.S AAAAAAAACT
LAT.CHALUM AAAAAAAAFJ
OCH.DANICA AAAAAAAACU
A.ADENINIV AAAAAAAAFK
S.LOMENTAR AAAAAAAACV
D.MELANO.2 AAAAAAAACW
T.CONGOL.2 AAAAAAAAFL
G.PUSILLUM AAAAAAAAFM
GNE.GNEMON AAAAAAAACX
F.NEOFOR.D AAAAAAAAFN
