AAIOHLA1 AAAAAAAAAA
FAAIABRY AAAAAAAAAB
SEEOOTTM AAAAAAAAAC
MSMSSMUE AAAAAAAAAE
HRMNAMMS AAAAAAAAAD
BASCAEED AAAAAAAAAF
DIYWEAEE AAAAAAAAAG
BATCESNI AAAAAAAAAH
LTOHAAEE AAAAAAAAAI
CLIRRN26 AAAAAAAAAJ
GEUGNSEM AAAAAAAAAK
AF113137 AAAAAAAAAL
AF083031 AAAAAAAAAM
TXPAAODI AAAAAAAAAN
XNPSOELS AAAAAAAAAO
HUMRG1 AAAAAAAAAP
LCPRUETM AAAAAAAAAR
SXFAAAEE AAAAAAAAAQ
XNPSSAVS AAAAAAAAAT
PLOOAAEE AAAAAAAAAS
PUBGIUAA AAAAAAAAAV
HMMLIAEE AAAAAAAAAU
SCHREII1 AAAAAAAAAW
NNOHSAIA AAAAAAAAAX
TIHLUESM AAAAAAAAAY
TRBRRN58 AAAAAAAAAZ
TAOOEAEE AAAAAAAABA
ARU34342 AAAAAAAABB
DGSATGIA AAAAAAAABC
TPRNALSU AAAAAAAABD
TIOEAQAE AAAAAAAABE
YSCRGIH5 AAAAAAAABF
CIOOTNAS AAAAAAAABG
CPC5825 AAAAAAAABH
PMC26S58R AAAAAAAABI
AA25SLS3 AAAAAAAABL
GADATNLS AAAAAAAABK
PAU34339 AAAAAAAABJ
PRASSAEE AAAAAAAABM
AF218207 AAAAAAAABO
PTOYMRNS AAAAAAAABN
RTUNVGCS AAAAAAAABP
TXPAAOD1 AAAAAAAABQ
GILRATEA AAAAAAAABR
ETMEOYIA AAAAAAAABT
DCYSAD2S AAAAAAAABS
PRCLARSA AAAAAAAABV
AF165818 AAAAAAAABU
CNIALIAS AAAAAAAABW
TELRAPR1 AAAAAAAABY
M26190 AAAAAAAABX
NFU34338 AAAAAAAABZ
GADAAMRS AAAAAAAACA
ETMPALCE AAAAAAAACB
OYASAD2S AAAAAAAACC
TGDNAPRRA AAAAAAAACD
SAHDRFRE AAAAAAAACE
SCJRDNA AAAAAAAACF
EPOECLTS AAAAAAAACG
ABU34340 AAAAAAAACH
RTLELTAA AAAAAAAACI
PMIRR17S AAAAAAAACJ
EGEARCLS AAAAAAAACK
TXPAAOD2 AAAAAAAACL
SCHREIIE AAAAAAAACP
NSMAEAP1 AAAAAAAACO
MTLAAAEE AAAAAAAACN
TLIAAAEE AAAAAAAACM
PMU58510 AAAAAAAACU
EMRATNLA AAAAAAAACT
XLRN01 AAAAAAAACS
M5U90885 AAAAAAAACR
OHOOSAIA AAAAAAAACQ
AOHLBMNS AAAAAAAACV
MQSRNAGN AAAAAAAACW
FNRAMTIA AAAAAAAACY
PM28SRRNA AAAAAAAACX
LPU34337 AAAAAAAACZ
DIDLSURNA AAAAAAAADB
MRHNYOPA AAAAAAAADA
AF036490 AAAAAAAADC
ETTESTUI AAAAAAAADD
HDOACLII AAAAAAAADF
TELRAPRA AAAAAAAADE
PAMDPRMS AAAAAAAADG
CIHDIUAA AAAAAAAADI
CERDNA AAAAAAAADH
YSGRG26S AAAAAAAADL
ECPAUIUI AAAAAAAADK
ECYHHAEE AAAAAAAADJ
AAIOHLAA AAAAAAAADM
PFU21939 AAAAAAAADP
PFMAL1P3 AAAAAAAADO
SALRIBRNA AAAAAAAADN
YSPRGBP AAAAAAAADS
ECEIHAOI AAAAAAAADR
EHDASAHA AAAAAAAADQ
CNIALIA1 AAAAAAAADT
CPC5825S AAAAAAAADV
NSMAEAPS AAAAAAAADU
DOOHOATR AAAAAAAADW
CHLLSURRNA AAAAAAAADX
LCU34336 AAAAAAAADY
AF205941 AAAAAAAADZ
SCHRUIEA AAAAAAAAEA
SHZSPNCS AAAAAAAAEB
TTRDNAG AAAAAAAAED
XNPSAD2S AAAAAAAAEC
OMU34341 AAAAAAAAEG
GADAAREE AAAAAAAAEF
JPOIAAEE AAAAAAAAEE
HUMRGM AAAAAAAAEI
SALRRN18 AAAAAAAAEH
PYAUEHLM AAAAAAAAEK
HC28SRIB AAAAAAAAEJ
TYAOACUI AAAAAAAAEL
DOOHOAT1 AAAAAAAAEM
